###########
#          #
#
######      
     #    ##
#####     #
#         #
##########
